00000000
00000010
01001111
11101110
11111111
